##############################
#............................#
#..#....##.#.#......#....#..##
#...............#...#.#..#..##
#............#.......#....#..#
#.....##...#..#..#.#.#.......#
##.#.#.##..#..#...........#..#
##.#.....###..#..#..........##
##.....#.............#.......#
#..#....#........#.#.......#.#
#.....#.........##....#.#.#.##
#...#.......#.###........##.##
##..#..................##....#
##.....##.#..#.........#...###
#.....#....#......####..#...##
#.##.......................#.#
#.#.....#......#........#..#.#
#.#....#..##.#....#..........#
#....#.#....#P.........#.....#
##############################
