##############################
#............................#
#..#....##.#.#......#....#..##
#...............#...#.#..#..##
#............#.......#....#..#
#.....##...#..#..#.#.#.......#
##.#.#.##..#..#...........#..#
##.#.....###..#..#..........##
##.....#.............#.......#
#..#....#........#.#.......#.#
#.....#...D.....##....#.#.#.##
#...#.......#.###........##.##
##..#..................##....#
##.....##.#..#.........#...###
#.....#....#......####..#...##
#.##........F..............#.#
#.#.....#......#........#..#.#
#.#....#..##.#....#..........#
#....#.#....#P.........#.....#
##############################
